8,6
0,0,0,7,1,0,0,0
0,8,0,0,1,2,1,10
0,1,0,0,0,0,4,0
0,12,1,1,0,0,1,0
0,1,0,3,0,0,1,11
6,1,0,1,9,1,5,0