10,10
0,0,0,0,0,0,0,8,1,1
0,1,0,0,0,0,1,1,0,5
0,1,0,0,11,1,1,0,0,0
0,7,1,1,0,0,1,0,0,0
0,0,2,1,0,0,1,0,0,0
0,0,0,1,1,1,1,1,1,10
6,0,0,0,1,1,0,0,0,0
1,0,0,0,3,0,0,0,0,0
12,0,0,1,1,1,1,0,0,4
1,1,9,1,0,0,1,1,1,1